#-#-##---------#------#-#-#---#-#----##---#----##-###-###-#-----#-#--#####---#-##-#--#--#-##-#-###---##-#-#-#---####--------#-----#-##--#-#---#---####-##-#--##-#-##-##-#--#---#--##-##-#-##---##-#####-#-#-#-#-#-##--#-#-#---##--##--#-#-#----########-#-#--##-#-##-#-##-----##--#-##-#----#-#---##-##-#-#---###-##-#--#--#--#-#-#-###---##----#-#-##--#-##--###-####-##-#-#-#-#-#---###---#-#-
##--#--#-#-------------#---#-#---------#-#-#---##------------#--#--##--###-#-#-#-#---#-------#-#---#-#---#---#-#-------###---#------##-#-#-#-#---------#-#---#-------#-------#-#-----#---#-##--#----##-#-#---#------##--##--##-##----#-###-##--#-##-##--##-#-#---------###-###--#--------#---#-#----##---#--##-#-------#-#-#-#-#---#-----------------#--##-#-#------#---#----#---------###-#-#--
#-#-###-#-#-#-#-#-#-###-#-#-#-#-###-#-###-#-#-#-#-#-###-###-###-#-#-#-#-#-#-#-###-#-#-#-#-#-#-#-#-#-#-###-#-#-#-#-#-###-#-###---#-#-###-#-#-###-#-#-###-#-#-#-###---#-#-#-#-#-#-#-#-#####-#-#-#-#-#-#---###-#-#-#-#-###-#-#-#-#-#-#-###-#-#-#-#-#-#-###-#---#-#-#-#-###-#-#-#-###-#-###-###-#-#-#-#-###-#-#-#-###-#-#-#-#-#-#-###---###-#-#-#-#-#-#-#-#-#-#-###-#-#-###-###-#-###-#-#-#-###-#-##
-#---#--##-###-###-#-#-###-#-#---#-#######-##-##-#-###-###---#-#-#-###-#-###-#---#-###-#-#-#-#-#-#-###-#-#-###-#-#-#-#-#-#-###-#-#-###-###-#-###-#-###-#-#-#-#---#-#-#-#-#---#-##--###---#---#-#-#-###-###---#-###---#-#-#-#####-#-#######-#-###-#-###-#-#--##-#-#-#-#-#-#-###-#-#-#####-#-#-#-#-#-###-#-#-#-#-###-###-#-#-#-#---#-#-###-#---#-#-#-###-###--###--#-#-#-#-#-#-#---#-#-#-###-#-#--
#-#---#-#-#-#-#-#-#---###-#-#-#-#-#---#-#-#-#-#-#-#---#-#-#-#-#-#-#-#-#-#-#-#-#-#-#---#-#-#-#-#-#-#---#-#-#-#-#-#-#-#-#---#-#-#-#-#---#-#-#-#-#-#-###-#-#-#-#-#-#-#---#-#-#-#-###-#---#-#-#-#-#-#-#---#-#-#---#-#-#---#-#-#---#---#---###-#---#-#-#-#-#-#-#---#-#-#---#-#-#-#-----#---#-#-#-#-#-#-#---###-#-#-#-#-#---#-#-#---#-#-#-#-#-#-#-#-#---#---#-#-#-#-###-#---#-#-#-#-#-#-#---#-#-#-#-#-
--#--#---###-##--------#--#--#-------#-#-------#-#----##---------------#-##-----------##-#---#---------#-##----------#-#-#---#-------#-------#---------#--#--#-#-#-------##--#---------------#---------#-----#---------#-#---##------#-#-#-----------#-#--#--#-----#-#-#--#-##-------#-#-##--#-------#-#--#--#---#---#-------#--#----#-#-----#-------------------------#--#----------#-#--##----
#-#-###-###-###-###-#-#-#-#-#-#-###-#-#-#-#-###-#-#-###-#-#-###-#-#-###-#---#-#-##--###-#-#-#-#-#-#-###-###-###-#-#-#-#-#-#-#-#-#-#-###-#-#-###-#-#-#-#-###--##-#-#-##--###-###-#-#-###-#-#-###-###-###-#-#-#-#-###-###-#-###-#-#-#-###-#-#-###-#-#-###-#-#-###-###-#-#-#-#-#-#-#-###-#-#-###-#-#-#-#-#-#-#-###--#--#-#-###-#-###-#-#-#-###-#-#-#-#-###-#-#-#-#-###-#-#-#-#-###-#-#-##--#-#-#-#-
-#-##-##---#---#----#--#-#-##--#-------#-#-#--##-----###-------#---#------####-#---#---#---#-#-#---#---#---#---#---##-##---#---#-#-##-##-#-#-#-#---#-----#-#---#---##--#-#-##--#-#-#---#-#-#---#-#-#---#-#-#---#-#-#--##-#-#---#---#-#-#---#---#--##---#-#-#-#-#---------#-#---#---#---#---#---#-#-----#---#---#------##-###---#-#-#---#--##--##--##-#-#---#-#-#---#---#---#---#----#--#-#-###-#
--#---###-###-#-#-##--#-#-#-#-###-##--#-#-##--###-###-#-###---#-#-###-#-#######-#-#-----####--###-##--#-#-#-#-###-##--#-###-#-#-#-##-----####-###-#---###-#---###-#---#---#---#-#-###-#-#-#-#-#-#-#---#-#-#-#-#-#-#---#-#-##----#-#-#-#-####--###-###-#-###---###-#-#-#-#-#-#-#-###-#-#-#-###-#-#-##--#-#-#-#-###-###-###-#-#-#-#-#---###-###-###-#-#-###-#-#-#-#-#-###-#-###-#-#-#---#-###-#-#-
-#-#---#---------#---##--#---#-----#---------#-----#-#---------------#---------------#---#---#-------#---#-------#-#------#--#---#-#-----#-----------------------#---------------#-##------------#-#----------#--#---#---------#---###----#------#-----------##--#-------#-------##-#----#---#----#------##------#-#-----#-------#--##-------#--#--------##--##----#-#---#-------#---#---#------
#-#-###-#-#-###-#-#-#-#-#-#-#-#-#-#-###-#-#-#-#-#-#---#-#-#-#-#-#-#-##--#-#-#-#-###-#-#-#-#-#-#-#-----#-#-#-#-#-#-#-###-#-#-#-#-#-#-#-#-#-#-#-#-#-#-#-#-#-#-#-###---##--#-#-#-#-#-#-###-#-#-#-#-#-#-###-#-#-#-#-#-#-###-#-#-#-#-#-#-#-#-#-#-#-#-#---#-#-#-#-#-#-#-#-###-#-#-#-#-#-#-#-#-#-#-#-###-#-#-#-#-#-#-#-#-#-#-#-#-#-#-#-#---#-#-#-#-#-#-#-#-###-#-#-#-#-###-###-#-#-#-#-#-#-###-#-#-#-#-
##-###-#-----#--##--#---##-##----#-#-#--##-##----#--#---#--###---#-##--###-###--##--#--##---##---#-###-##--#--#--#-#-#-##--##---##-###--##-##---##-###--##-#--#-##-##--#-#--#---##-###-#-#-##----#--#--###--#--###-##--#---##-#-##-###-#---##----#--#---#--##-#-##--#--###-##---#--##------###---#-##--##--###--##--#--#---###---#-#-#--#--##-#--#-###--##-###---#-#----#-------##--#---##-##---
-##-#-#-#-#---#---###-#-#-##--#-#---#-#-#####-#-#-#-#-#-#-#-#-#-#---#-#-#-###-#-#-#-#-#-#-#---#-###---#-#-###-#-#-###-#-#-###-#-#-#---#-#-##--#-#-#-#-#-#-###-#-#-###-#---#-#-#-#-###-#-#-#---#---#-#-#-#-###-###-#-#-##--###-#-#-#-###--##-#-#-#-#-#-#-#-###-#-#-##-##-#-#-#-#-#-#-#-#-#-###-###-#-#-#-#-#-#-#---#-#-#-#-#-#-#-#-#-#-#-#-#-#-#-#-#-#-#-#-##--#-#-#-#-#-#-###-#-###-#-#-#-#-#-#-
--#--#-------#----#--#-------#-------#---#---#----#--#---#---#------------#--#-------#----#--#---#---#----#----------#----#----------#----#--#---##--#-#-----#---------------#--#----#----#--#----#----#-------------#----#--#-------#--##---#----#------#---#--#----#-------#-------#--#----#---###-#-------#-------#----#--#--#----#----#--#----#--#----#------##----------#-------#----#-----
#-#-###-#-#-#-#-###-#-#-#-#-#-#-#-#-#-#-#-#-###-#-#-#-###-#-###-#-#-##-##-#-#-#-###-#---#-#-###-#-#-#-#-#-#-#-#-#-#-#-#-#-#-#-#-###-#-#-#-#-#-#-#-#-#-#-#-#-#-#-###-#-#-#-#-#-#-#-#-#-#-#-#-#-#-#-#-#-#-###-#-#-###-#-#-#-#-#-#-#-#-#-#-#-#-#-#-#-#-#-#-#-#-###-#-###-#-###-#-#-#-#---###-#-#-#-#-#-#-#-#-#-#-#-#-#-#-#-#-#-#-#-#-#-#-#-#-#-#-#-#-#-#-#-#-#-#-#-###-#-#-#-#-#-#-#-#-#-#-#-#-#-#-
---#---#-#---#-#-------#-------#---#-----#-#-#-#---#-#-#-#-#-#-----#---#-------#---#---#---#-#-----#---#-#-----#-----#-#-#---#-----#---#---#---#---#-----------#---#-------------#-#---#-#-#---#---#-----#-#---------#-#---#-------#-----#-#---#---#-------#---#-#-#---#-#-----#---#-----------#---#-----#---------#-----#-#-#-----#---#---#---#---#---#---#---#---#-------#---#---#---------##-