-#-##--##-##--#-#-#-###-#-----#-##-####-#-##------##--#-#--##--##-#-#---#-##--#-#-##-##-##-----#--#-#--##-#---#-#-#--#--#--#--###-##--#-#-##----#-##--##--#---###-####-###--##-##-#--#--####---#--##-#######-##-#-##----#-#--#--#-###---#-#---#-#-####-##-#-#--##-###-#-###---#-#-##-#--##-#---##-#-#-#-#-#-#-#####-----#-#--###--#######-###---#---##--#-###--##-#-----#-##--##--#-##----##----
-----#------##-#-----#-##---#--#-----#---#---------#-#--#----#-----------#---#--##-----#-#-#-#-#---#-----#-#-#------#---##---#-#--------##----------------------#-------#--#-#---------#####----#----#--#----#--#--##--#-#-#-#-#-----#---#-#-#-#---###-##----#----#-----#----#-#-------###---#-#-------###---#-#-------##--#-----------###-#-#---#-#---##----#-------#-#-#---#-----#---#------#-
#-#-#-#-#-#-#-#-#---###-#-#-#---###-###-#-#-#--##-#-#####-#-#-#-#-#-#-##-##-#-#-#-#-#-#--##-#--##-#-###-#-#-#-#-#-#-#-#-#-#-#-#-#---###-###-#####-#-#-#-#---#-#####-###-#-#-#-#-#-#-#-#-###-#-#-#-#-###-#-#-###-#-#-####-##-#-#-#-#-#-#####-#---#-#-###-#-#-#-#-#-#-###-#-#-##--#---#-#-#-#-#####-#-###-#-#-#-#-#-#-###-#-#-#-###-#-###-###-#-###-#-###-#-#-###-#-#-##--#-#-#-###-#-#####---#---
-#--##-#-#-#-#-#-#-#-#-#-#-#-###-#-###-#-#-#-###-#-#-#---#--####-#-###-#-#---#-#-#-#-#-#-#-#-#-#-###-#-#-#---###-#-#-#-#-#---#-#-#-###-#-#-#-#-#-#-#-#-###-####--#-###-###-###-#-#-##--###-#-#-#-#-###-###-#-##--#-###-#-#-#-###-#-#-#-#-#-#-#-#-#-#####-#-##----#-###-#-#-#-#-#-#---#-#-#-#-#-#-#-#-#---#-#-##--#---#-#-#---#-#-#-#-###-#-###---#-#-#####-#-#-#-#-#-#-#-#-#-#-#-#-#-#####-#-##-
--#-#-#-#-#---###-#---#-#-#-#-#-#-#---#-#-#-#-#---###-#-#-#---###-#---#-#-#-#-#---#---#-#-#-#-#-#-#---#-#-#-#-#-#-#---#-#-#---#---#---#-#-#-#-#-#-#-#-#-#-#-#-#-#-#-#-#-###-#-#-#---#-###-#-#-###-#-#-###-#-#-#-#-#---#-#-#-#-#-#-#---#-#-#-#-#-#-#-#-#-#-#-#-#-#-###-#-#-#-#-#-#-#---###-#-#-#-#-#---#-#-#-#-#---#-#-#-#-#-#-#-#-###-#-#-#---#-#-###-###-#-#-#-#-#---#-#-#---#---#-#-#-#-#-#-#-
--------##---#-------#---##-----#----###-----#-------#-#--------------#------#---#----#---#--##------#-#--#--#---#---###-#---#------------#--##-#-------###--#------------#--##--#---###-----#-------#-----------------#--#--##--#---#-#--------##-----#-----#-------##--#---#-------#-#--#--#---------#--#------------#-----#-#-----###-----#--------#------##----------#---#-------#--##---#--
###-#-#-#-#######-#-###-###-###-###-##--#-#-#-###-#-###-#-#-###-#-#-#-#-#####-#-#-#-###-#-#-#-#-#-#-#-#-###-###-###-###-#-#-###-#-#-#-#-###-###-#-#-###-#-#-#-#-###-###-#-#-###-###-###-#-#-###-#-#-#-#-#-#-###-#-#-###-#-#-###-#-#-#---#-#-#-#---#-###-#-#-###-###-###-#-#-###-#-#-###-#-#-#-#-#-#-###-###-#-#-#-#-###-#-#-#-#-#-#-###-###-#-#-###-#-#-#---###-#-#-#-#-#-#-###-###-#####-#-#-#-
---##--#---#---#-#-#---#---##--#---##--#---#-#-#---#---#-#-#---#-#-#---#---#-#-#---#---#---#---#---#---#-#--##-#---#---#---###-#---#-#-#-#-#---#---##--#---#-#-#---#---#---###-#---#---#---###-#---#---#---#-#-#-------#-#-#---#---##--#-###--------#-##-####--#-#-#-#-#-#-#---#-###-#-#-#-#-#-#---#-#-#-#-##--#---#---#---##--#---##--#---#---#---#--##---#---#---#--##-#-#-#-#---##--#---#-#-#
--#---#-#-#---#-#-##--#-###-#-###-##--#-###-#-###-#---#-###-#-#-#-##--#-#-#---#-#-##--#-###-#-###-#---##-###--###-#-#---###---#-#-#-#-#-#####-#-#-##---####-#-#-#-##--#-#-#-#-#-#-##--#-#-###-#-#-###-#-####--###-###-#-#-###-#-#-#---#-#-#-#-###-###-###-##--#######-##-####-#-#-###-#-###---#######-#-#-###-#-#-#---#-###---###-#-#-#-###-#-#-#-#-#-#######-#######-#---##--#-###-#-###-###-#-
-#-#---------------------------------#---#---#---------#---------###-#---#-------#-#-----#--------###------------#---#----------#---#------------#------------#--------------#---#-------#---#------#--------#-----#-----------#---##----#-------#-#-----#---------------#--------#--#----#------##--#---##--------###---#-------##--#---#---#-----------------------------------###---------#--
#-#-#-#-#-#-###-#-#-#-#-#-#-#-#-#-#-#-#-#-#-#-#-#-#-#-#-#-#-###-#-#-#---#-#-#-#-#-#-###-#-#-###-#-#-###-#-#-#-#-#-#-#---#-#-#-#-#-#-#-#-#-#-###-#-#-#-#-#-#-#-#-#-#####-#-#-#-#-#-#-#-#-#-#-#-#-#-#-###-#-#-#-#-#-#-#-#-#-#-#-#-###-#-#-#-#-#-#-#-#-#-#-#-#-#-#-#-#-#-#-#-#-#-#-#-#-###-#-#-#-#-#-#-#---#-#-#-#-#-#-#---#-#-###-#-#-#-#-#-#-#-#-#-#-#-#-#-#-#-#-#-#-###-#-#-#-#-#-#-###-#-#-##--
-#-###-#---####--#-###--##-##--###-###--##-#-#--##-#-#--##-###--##-###-##---####-#---------##---##-##----#-###-#-#-##--#-#-###--##--##-###--#-#-#--##--#-#-##-#-##-#######-##-#--#-###-###-#-#---#-###-#---#--#--#--##--#--##----#-##------####-##-###-###-###-###-##--##--####-##-###-----#--------##-###----#--#-##-------#---#-------##--##---#-###-#-#-##----#-###-###-##-##-#--#----#-#----
#-##--#-#-#-#-#-#-###-----#-#-#-#-###-#-#-##--#-#-#-#-###-###-#-#-#-#-#-#-#-#-#-#-#-#-#-#-#-#-#-#-###-#-#-###-#-#-#-#-#-#-#-#-#-#-###-###-#---#-#-##--#-#-#-#-###-#-#-#-#-#-#-#-#-#-#-#-#####-#-#-#-#-#--###--#-#-#-#-#-#-##--#-#-#-#-#-#-###-#-#-###-#-#-#-###-###-#-#-#-###-######--#-#-#-#-#-#-#---#-###-#-#-#-#-#-#-#-###-#-#-#---#-###---#-#-###-#-#-###-#-#-##--#-#-###-#-#-#-#-#---#-#-#-
-##--#-#-##--#---##--#----#--#----#--#----#--#--###--#--###--#----#--------------#---#---#---#---##--#--#-#--#-------#----#--#----#--#--###----------#----------#-##-#----#--#----#--#----##-#----#--#----#--#-------#-----------#--------#--##---#--#---##--#---#---#----#--#--#-#--#---#---#------------#--#-------#-#-----#----#--#---##--#----#--#--#-#--#-------#--###--#--#-#--#---#------
#-#-#-#-#-#-###-#-#-#-###-#-###-###-#-#-#-#-#-#-#-#-#---#-#-#-#-#-#-#-###-#-#-#-#-#-#-#-#-#-#-#-#-#-#-#-#-#-#-#-#-#-#-###-#-#-#-#-#-#-#-#-#-###-#-#-#---#-#-#-#-#-#-#-###-#-#-#-#-#-#-###-#-#-#-#-#-#--##-#-#-#-#-#-#-#-#-#-#-#-#-#-#-#-#-#-#-#-#---#-#-#-#-#-#-#-#-#-#-#-#-#-#-#-#-#-#-#-#-#-#-###-#-#-#-#-#-#-#-#-#-#-#-#-#-#-#-#-#-#-#-#-#-#-###-#-###-#-#-#-#-#-#-#-#-#-#-#-#-#-#-#-#-#-#-#-
---#---#-------#---#-----------#---#---#---#---#---#---#---#-#-----#---#-------#---#---#---#-#-#---#-#-----#-#-#---#---------#-----#---------#-#-----#-----#---#---#-----#-----#-------#---#-----------#-----#-#---#-----#---#-#---------#-#---#---#-----------#---#---#---#-#-#---#---#-----------#-----------#---#-----#-#---#---#-#-#-#-#---#-#-------#-----#---#-#-----#---#---#-#----------