-----------B-----#---e-c--pc-----cp--P?c--Pc-----c---?-?--#P-----#-----#---P-----?---#-B---c-----B-----#---P-----#---------e---------------P-----B---#-?--#c-----e---B-p--#c-----P---PBc--cc-----cp--P?c--Pc-----P---#-#---e-----------------------------------------------#---------------?---------#-B---c-----P---P?c--cc-----cP--ccc--cc#----cc-Bccc#-ccB----cc-?ccc#-cc#----cc-------------
--------------p---c-?B-----#--c-c-c-c------#--c-#-c-c---------P---P-----------c---c-B---------c---c-B---------p---P--------B--?---p-----------P---c-B---------c--Bc-e---------c---c-c--B-?-P--c-c-c-c----#----c---c-e------B--#---e-------------------------------------------#---?-----------e---P-----------c---c-c--?-p-P--c#c-c#c--c-c-c-#cPc-cpc--c-c-c-Bccc-cec--c-c-c--cpc-c-P-----------
#-------c---c-----P---c-c---cc-P--c---c-#---cc-e--c---c-P---c-----c---P-c---c-----c---c-c---cB----c---c-c---c-----P---p-c---c-----e---?-c---c-----c---c-c---cB----c-B-c-P---cP-#--c---c-----cc-c--c---c-#---cP-#--c-B-c-c---c-----?-----c---c-----------c---c-----------c---c-----B---#-c---c-B---p---P-c---cp-#--c---c-#---cc-c--c---c---#-cc-c--c---c---?-cc-c-#cB--c---B-cc-c--c---c-----#---
----------e-----c---c-----c---c-c---c-----c---cBc---c-----c-----c---c-----c---B-c---c-----c---P-c---c-----c-----c---c-----c-----P-B-c-----c---B-c---c-----c---e-c---c-----c---c-c---c-----c---c-p---c-----c---c-c---c-----c-----p---e-----#---------#-----#---------#-----p-----e---P-----c-----c---c-----c---c-c---c-----c---c-P---c-----cc--cp----c-----cc-#cP-#--c-----cP--c#B---c-----------
-----c---cBc---c-----c---ccpc-ce#----c---ccPc-Pc-----c---cccc--c-----c---cPcc--c-----c---cccc--c-----c---cPcc--c-----c---cBc?--c-----c---cecc--c-----c---cccc-Bc-----c---cccc-#c-----c---cc#c-cBp----c---ccPc-Bc-----c---cPcP--c----Bc---c-c---c-----c---c-c---c-----c---c-c---cB----c---cBc?--c-----c---cccc-#c-----c---cc?c-c#P----ce--cc-c-c-c----cc--cc-c-c-c----cP--cc-c-c-c---------------
------------------p----c--#?c#c#Pcc----c---#c-P-#?c----e----------p----#----------c----?----?-#---c----#----------?---------------B-------B-------c----B----B-#---c----P----P-?--#c----c#-#pcBc#ccc----c----c-?--#c-------------------------------------------------------------------------------e----B----p-B--#c----cB-#Pc?cPccc--p#cc-?cccccccc--cBcc-Pcccccccc--P#cc-?ccPcPccc-------------
#--------------cc--c-----cc-Pc-cc--c-----cc-?c-cc--c---B-B#--B-cc--P-----#---P-cc--c-----B#--c-cc--c---------B-cc--p-----------Pc--p---------p-cc--c-----B---c-cc--c-----eB--c-cc--c-----cc-cc-cc--c-----Pc-#c-cc--c-----------pc--#------------c---------------c--#-----------pc--B---------#-Pc-Bc-----?---c-cc--c-----cc-cc-cc--c-----cc-cc-cc--c-----cc-cc-cc--c-----cc-cc-cc--p------------
-----------?---c------P---pc-c-e-cc---c---pc-c-c-cP---P----c-B-c-#----B----c-?-c-?B---P----c-P-c-e?---p----p---c------#----e---c------#----P-B-c-#----p----c-P-c-pB---P--B#c-c-c-cP---c---cc-c-#-cc---c---pc-c-c-cp---p----e---c---------------c---------------c-----------B---c-----------p---c------B----c-c-c-cp---c---cc-c-B-cc---c---cc-c---cc---c---cc-c---cc---c---cc-c---cc---#---------
-----------c-c-c-c--#-----ccPc-ccc--c-----ccpc-ccc--c-----cc-c-c-c--------pc-c-cec--e-----cc-c-cPc--?-----ec-c-c-c--------#c-c-c-c--------?c-c-c#c--#-----cc-c-cpc--p-----cc-c-ccc--c-----cccc-ccc--c-----cc?c-ccc--P-----Bc-c-c-c---------c-P-c-c---------c-P-c-c---------c-c-c-c--------#c-c-c-c--------cc-c-ccc--c-----cccc-ccc--c-----cccc-ccc--c-----cccc-ccc--c-----cccc-ccc--c-----------
--------------cpc-c-c------#--ccecc-ce--------ccPec-c#--------cec-c-c---------cPc-c-c---------ccc-c-c-----B---Pec-c-P---------pBc-c-p---------cPc-c-c---------cPc-c-c---------ccP?c-c?-----#--ccBcc-ce--------ccPBc-c---------p#c-c-?---------#-c-c-----------#-c-c-#---------p-c-c-e---------cBc-c-c---------ccPpc-cB-----B--ccBcc-cc-----P-Bcc-cc-cc-----P-Bcc-cc-cc-----P--cc-cc-c-----------
#------cc--------#cc--cccc------Bcpc-Bcccc-------Pcc--cccp-----B--cc--ccc?-------?cc--cccp-------ecc--ccPB-----B--cc--ccc---------cc--ccc#-------Bcc--ccce-------Bcc--cccp-------pcc--cccc-------c?c-Bcccc-------pcc--ccPB--------ce--cPP---------c?--pcc---------ce--Pcc---------ccB-ccc---------cc--ccce-------Pcc--cccc-------cBc--cccc-------c-c--cccc-------c-c--cccc-------c#P--c---------
-------?-----------c---c?---#ec--#Bc---cB----Be----c---c-----------c---c-----------c---c------#--B-c---P-----------P---P-----------P---c-----------c---c-B---------c---c-----##----c---c?----BP--BBc---c#----#e----c---P-----------?---e-----------#---?-----------#---P-----------p---c-----------c---c#B---#B----c---ce---#Pc--Pec-P-cc?--pcc--ccc-c-cPB--pcc--ccc-P-cP#--?Pc--eec---#--------
-----P-#-#-----------c?P-c--cB----c--cB?-c--c-B---?--c---c--P--------c-#-P--P--------c##-c--P-----#--c---?--B--------c---?--#--------c---p--B--------c-#-c--p--------c-B-c--c-----B--c?P-c--c-----P--cB?-c--c-B---B--c---e--?--------P-B-------------c---------------c---#-----------c---p--#--------c-e-c--c-----B--c?PBc--c-----c--cccBc--c-----c--cPcec--c-----c--cccBc--c----Bc-------------
-------------#------------c--c-cc---#-----c--c-pP---------P--B------------p--P--B---------c--c-#p---------B--#------------#---------------#--B--#---------e--e--#---------P--c-Bp---------c--c-cc---------c--c-eP--------B?--#------------------------------------------------------------#--#---------B--c--c-BP---------c--c-cc#--B---#-c--c-cc?--P---B-c--c-cc?--P---#-c--c-cc---------------
----------------p-c-ccc#-e-----#c-cBccc#-?------c-c-cPc---------p-c-c#c---------P-c-cPc---------c-c-c#c---------?-c-c-p---------B-P-c-P---------P-c-cBc---B--B--P-c-cpc---------c-c-ccc#-p------c-c#ccc#-B-----Bc-c-cBc---------#-p-c-?-----------#-P-------------#-c-----------?-P-c-p---------e-c-c?c---------c-c-ccc#-P-----#c-cPcccc-c-#---Pc-cccccc-c#B---Pc-cccccc-c-----?c-c-c-c---------
################################################################################################################################################################################################################################################################################################################################################################################################